0,0,0,0,0,0,0,0,0,0,0,0,0,0,0,0,0,0,0,0
0,0,0,0,0,0,0,0,0,0,0,0,0,0,0,0,0,0,0,0
0,0,2,2,2,2,2,2,2,2,2,2,2,2,2,2,0,0,0,0
0,0,2,0,0,0,0,0,0,0,0,0,0,0,0,2,0,0,0,0
0,0,2,0,0,0,0,0,0,0,0,0,0,0,0,2,0,0,0,0
0,0,2,0,0,0,0,0,0,0,0,0,0,0,0,2,0,0,0,0
0,0,2,2,2,2,2,2,2,2,0,0,0,0,0,2,0,0,0,0
0,0,0,0,0,0,0,0,0,2,0,0,0,0,6,6,6,0,0,0
0,0,0,0,0,0,0,0,0,2,0,0,0,0,0,11,0,0,0,0
0,0,0,0,0,0,0,0,0,2,0,0,0,0,0,0,0,0,0,0
0,10,6,2,2,2,2,2,2,4,0,0,0,0,0,0,0,0,0,0
0,0,0,0,0,0,0,0,0,2,0,0,0,0,0,0,0,0,0,0
0,0,0,0,0,0,0,0,0,2,0,0,0,0,0,0,0,0,0,0
0,0,0,0,0,0,0,0,0,2,0,0,0,0,0,0,0,0,0,0
0,0,0,0,0,0,0,0,0,2,0,0,0,0,0,0,0,0,0,0
0,0,0,0,2,2,2,2,2,2,0,0,0,0,0,0,0,0,0,0
0,0,0,0,2,0,0,0,0,0,0,0,0,0,0,0,0,0,0,0
0,0,0,0,2,0,6,0,0,0,0,0,0,0,0,0,0,0,0,0
0,0,0,0,2,2,6,13,0,0,0,0,0,0,0,0,0,0,0,0
0,0,0,0,0,0,0,0,0,0,0,0,0,0,0,0,0,0,0,0
,,,,,,,,,,,,,,,,,,,
