0,0,0,0,0,10,0,0,0,0,0,0,0,0,0,0,0,0,0,0
0,0,0,0,0,6,0,0,0,0,0,0,0,0,0,0,0,0,0,0
0,0,0,0,0,2,0,0,0,0,0,0,0,0,0,0,0,0,0,0
0,0,0,0,0,2,0,0,0,0,0,0,0,0,0,0,0,0,0,0
0,0,0,0,0,4,2,2,2,2,2,2,2,2,2,2,2,0,0,0
0,0,0,0,0,2,0,0,0,0,0,0,0,0,0,0,2,0,0,0
0,0,0,0,0,2,0,0,0,0,0,0,0,0,0,0,2,0,0,0
0,0,0,0,0,2,0,0,0,0,0,0,0,0,0,0,2,0,0,0
0,0,0,0,0,2,0,0,0,2,2,2,2,2,2,2,2,0,0,0
0,0,0,0,0,2,0,0,0,2,0,0,0,0,0,0,0,0,0,0
0,0,2,2,2,2,0,0,0,2,0,0,0,0,0,0,0,0,0,0
0,0,2,0,0,0,0,0,0,2,0,0,0,0,0,0,0,0,0,0
0,0,2,0,0,0,0,0,0,2,2,2,2,2,2,2,2,2,0,0
0,6,6,6,0,0,0,0,0,0,0,0,0,0,0,0,0,2,0,0
0,0,13,0,0,0,0,0,0,0,0,0,0,0,0,0,0,2,0,0
0,0,0,0,0,0,0,0,0,0,0,0,0,0,0,0,6,6,6,0
0,0,0,0,0,0,0,0,0,0,0,0,0,0,0,0,0,11,0,0
0,0,0,0,0,0,0,0,0,0,0,0,0,0,0,0,0,0,0,0
0,0,0,0,0,0,0,0,0,0,0,0,0,0,0,0,0,0,0,0
0,0,0,0,0,0,0,0,0,0,0,0,0,0,0,0,0,0,0,0
