0,0,0,0,0,0,0,0,0,0,0,0,10,0,0,0,0,0,0,0
0,0,0,2,2,2,2,0,0,0,0,0,6,0,0,0,0,0,0,0
0,0,0,2,0,0,2,0,0,0,0,0,2,0,0,0,0,0,0,0
0,0,0,2,0,0,2,0,0,0,0,0,2,0,0,0,0,0,0,0
0,0,0,2,0,0,2,0,0,0,0,0,2,0,0,0,0,0,0,0
0,0,0,2,0,0,2,0,0,0,0,0,2,0,0,0,2,2,2,0
0,0,0,2,0,0,2,2,2,2,2,2,4,2,2,2,2,0,2,0
0,0,0,2,0,0,0,0,0,0,0,0,0,0,0,0,0,0,2,0
0,0,0,2,0,0,0,0,0,0,0,0,0,0,0,0,0,0,2,0
0,0,0,2,0,0,0,0,0,0,0,0,0,0,0,2,2,2,2,0
0,0,0,2,2,2,2,2,2,2,2,0,0,0,0,2,0,0,0,0
0,0,0,0,0,0,0,0,0,0,2,0,0,0,0,2,0,0,6,0
0,0,0,0,0,0,0,0,0,0,2,0,0,0,0,2,2,2,6,11
0,0,0,0,0,0,0,0,0,0,2,0,0,0,0,0,0,0,6,0
0,0,0,6,6,0,0,0,0,0,2,0,0,0,0,0,0,0,0,0
0,0,12,6,6,2,2,2,2,2,2,0,0,0,0,0,0,0,0,0
0,0,0,6,6,0,0,0,0,0,0,0,0,0,0,0,0,0,0,0
0,0,0,0,0,0,0,0,0,0,0,0,0,0,0,0,0,0,0,0
0,0,0,0,0,0,0,0,0,0,0,0,0,0,0,0,0,0,0,0
0,0,0,0,0,0,0,0,0,0,0,0,0,0,0,0,0,0,0,0
,,,,,,,,,,,,,,,,,,,
