0,0,0,0,0,0,0,0,0,0,0,2,1,1,2,1,1,2,1,1,2,1,1,2,1,1,2,0,0,0,0,0,0,0,0,0,0,0,0,3
0,0,0,3,0,0,0,0,0,0,0,2,1,1,2,1,1,2,1,1,2,1,1,2,1,1,2,0,0,3,0,0,0,0,0,0,0,0,0,0
0,0,0,0,0,0,0,3,0,0,0,2,2,2,2,2,2,2,2,2,2,2,2,2,2,2,2,0,0,0,0,0,0,0,0,0,0,3,0,0
0,0,0,0,0,0,0,0,0,0,0,2,0,0,2,0,0,2,3,0,2,0,0,2,0,3,2,0,0,0,0,0,0,0,0,0,0,0,0,0
0,0,0,0,0,0,0,0,0,0,0,2,3,0,2,6,0,2,0,0,2,0,6,2,0,0,2,0,0,0,0,0,0,0,0,0,0,0,0,0
4,0,0,0,0,0,0,0,0,0,0,2,0,0,2,0,0,2,0,6,2,0,0,2,0,0,2,0,0,0,0,0,0,3,0,0,0,0,0,5
0,0,0,3,0,0,3,0,0,3,0,2,0,0,2,0,0,2,0,0,2,0,0,2,0,0,2,0,0,0,0,0,0,0,0,0,0,0,0,0
0,0,0,0,0,0,0,0,0,0,0,2,2,2,2,2,2,2,2,2,2,2,2,2,2,2,2,0,0,0,0,0,0,0,0,0,0,0,0,0
0,0,0,0,0,0,0,0,0,0,0,2,1,1,2,1,1,2,1,1,2,1,1,2,1,1,2,0,0,0,0,0,0,0,0,0,3,0,0,0
0,3,0,0,0,0,0,0,0,3,0,2,1,1,2,1,1,2,1,1,2,1,1,2,1,1,2,0,0,3,0,0,0,0,0,0,0,0,0,3
