2,2,2,2,2,2,2,2,2,2,2,2,2,2,2,2,2,2,2,2,2,2,2,2,2,2,2,2,2,2,2,2,2,2,2,2,2,2,2,2
0,2,0,3,0,0,2,0,3,0,0,0,2,0,0,0,0,0,2,0,0,3,0,0,2,0,0,3,0,0,2,3,0,0,2,0,0,0,0,0
0,2,0,1,3,0,2,0,3,1,3,0,2,0,3,1,3,0,2,0,3,1,3,0,2,0,3,1,3,0,2,3,1,3,2,0,0,0,0,0
0,2,0,0,0,0,2,0,0,0,0,0,2,0,0,0,0,0,2,0,0,0,0,0,2,0,0,0,0,0,2,0,0,0,2,0,0,0,0,0
0,2,0,0,0,0,2,0,0,0,0,0,2,0,0,0,0,0,2,0,0,0,0,0,2,0,0,0,0,0,2,0,0,0,2,0,0,0,0,5
4,2,0,0,0,0,2,0,0,0,0,0,2,0,0,0,0,0,2,0,0,0,0,0,2,0,0,0,0,0,2,0,0,0,2,0,0,0,0,0
0,2,0,0,0,0,2,0,0,0,0,0,2,0,0,0,0,0,2,0,0,0,0,0,2,0,0,0,0,0,2,0,0,0,2,0,0,0,0,0
0,2,0,1,3,0,2,0,3,1,3,0,2,0,3,1,3,0,2,0,3,1,3,0,2,0,3,1,3,0,2,3,1,3,2,0,0,0,0,0
0,2,0,3,0,0,2,0,3,0,0,0,2,0,0,0,0,0,2,0,0,3,0,0,2,0,0,3,0,0,2,3,0,0,2,0,0,0,0,0
2,2,2,2,2,2,2,2,2,2,2,2,2,2,2,2,2,2,2,2,2,2,2,2,2,2,2,2,2,2,2,2,2,2,2,2,2,2,2,2
