0,0,0,0,0,2,0,1,3,0,2,2,2,2,2,2,2,2,2,2,2,2,2,2,2,2,2,2,2,2,2,2,2,2,2,2,2,2,2,2
0,0,0,0,0,2,2,2,2,2,2,1,3,3,3,1,0,2,0,1,3,3,3,1,0,2,0,1,3,3,3,1,0,2,0,0,0,0,0,0
0,0,0,0,0,2,1,0,0,0,2,0,0,0,0,0,0,2,2,2,2,2,2,2,2,2,2,2,2,2,2,2,2,2,0,1,3,3,1,0
0,0,0,0,0,2,3,1,3,1,2,1,3,3,3,1,0,2,0,1,3,3,3,1,0,2,0,1,3,3,3,1,0,2,2,2,2,2,2,2
0,0,0,0,0,2,0,0,0,0,2,2,2,2,2,2,2,2,2,2,2,2,2,2,2,2,2,2,2,2,2,2,2,2,0,0,0,0,0,5
4,0,0,0,0,2,0,0,0,0,2,0,0,0,0,0,0,2,0,0,0,0,0,0,0,2,0,0,0,0,0,0,0,2,0,0,0,0,0,0
0,0,0,0,0,2,3,1,3,1,2,1,3,3,3,1,0,2,0,1,3,3,3,1,0,2,0,1,3,3,3,1,0,2,2,2,2,2,2,2
0,0,0,0,0,2,1,0,0,0,2,2,2,2,2,2,2,2,2,2,2,2,2,2,2,2,2,2,2,2,2,2,2,2,0,1,3,3,1,0
0,0,0,0,0,2,2,2,2,2,2,1,3,3,3,1,0,2,0,1,3,3,3,1,0,2,0,1,3,3,3,1,0,2,0,0,0,0,0,0
0,0,0,0,0,2,0,1,3,0,2,2,2,2,2,2,2,2,2,2,2,2,2,2,2,2,2,2,2,2,2,2,2,2,2,2,2,2,2,2
