2,2,2,2,2,9,2,2,2,2,2,2,2,2,2,2,2,2,2,2,2,2,2,2,2,2,2,2,2,2,2,2,2,2,2,2,2,2,2,2
2,0,3,0,0,0,3,0,0,3,0,0,3,0,0,0,0,0,3,0,2,0,0,0,0,0,0,0,0,0,0,0,0,0,0,0,0,9,0,0
2,0,1,3,0,0,1,0,0,1,0,0,1,0,0,1,3,0,1,0,2,0,1,3,1,0,0,0,1,3,0,0,0,1,0,0,1,0,0,0
2,0,0,0,0,0,0,0,0,3,0,0,0,0,0,0,0,0,3,0,2,0,0,0,3,0,0,0,3,0,0,0,3,3,0,0,3,0,0,0
2,0,0,0,0,0,0,0,0,0,0,0,3,0,0,0,0,0,0,0,2,0,0,0,0,0,0,0,0,0,0,0,0,0,0,0,0,0,9,5
2,0,0,0,0,0,0,0,0,0,0,0,0,0,3,0,0,0,0,0,2,0,0,0,0,0,0,0,1,0,0,0,0,0,0,9,0,0,0,0
2,0,3,3,0,3,0,0,3,3,0,0,0,0,0,0,0,3,0,0,2,0,0,0,0,3,0,0,0,0,0,0,0,0,0,0,0,1,3,0
2,0,1,0,0,1,0,0,1,0,0,1,0,0,1,0,0,1,3,0,2,3,3,3,0,1,0,0,0,0,3,3,3,1,0,0,0,3,0,0
2,0,3,0,0,3,3,0,0,0,0,0,0,0,3,0,0,3,0,0,2,0,1,0,0,0,0,0,0,0,0,0,0,0,0,0,0,0,0,0
2,2,2,2,2,2,2,2,2,2,2,2,2,2,2,2,2,2,2,2,2,2,2,2,2,2,2,2,2,2,2,2,2,2,2,2,2,2,2,2
4,6,6,6,6,6,6,6,6,6,6,6,6,6,6,6,6,6,6,6,6,6,6,6,6,6,6,6,6,6,6,6,6,6,6,6,6,6,6,6
2,2,2,2,2,2,2,2,2,2,2,2,2,2,2,2,2,2,2,2,2,2,2,2,2,2,2,2,2,2,2,2,2,2,2,2,2,2,2,2
2,0,3,0,0,0,3,0,0,3,0,0,3,0,0,0,0,0,3,0,9,0,0,0,0,0,0,0,0,0,0,0,0,0,0,0,0,0,0,0
2,0,1,3,0,0,1,0,0,1,0,9,1,0,0,1,3,0,1,0,2,0,1,3,1,0,0,0,1,3,0,0,0,1,0,0,1,0,0,0
2,0,0,0,0,0,0,0,0,3,0,0,0,0,0,0,0,0,3,0,2,0,0,0,3,0,0,0,3,9,0,0,3,3,0,0,3,0,0,0
2,0,0,0,0,0,0,0,0,0,0,0,3,0,0,0,0,0,0,0,2,0,0,0,0,0,0,9,0,0,0,0,0,0,0,0,0,0,0,5
2,0,0,0,0,0,0,0,0,0,0,0,0,9,3,0,0,0,0,0,2,0,0,0,0,0,0,0,1,0,0,0,0,0,0,0,0,0,0,0
2,0,3,3,0,3,0,0,3,3,0,0,0,0,0,0,0,3,0,0,2,0,0,0,0,3,0,0,0,0,0,0,0,0,0,0,0,1,3,0
2,0,1,0,0,1,0,0,1,0,0,1,0,0,1,0,0,1,3,0,2,3,3,3,0,1,0,0,0,0,3,3,3,1,0,0,0,3,0,0
2,0,3,0,0,3,3,0,0,0,0,0,0,0,3,0,0,3,0,0,2,0,1,0,0,0,0,0,0,0,0,0,0,0,0,0,0,0,0,0
2,2,2,2,2,2,2,2,2,2,2,2,2,2,2,2,2,2,2,2,2,2,2,2,2,2,2,2,2,2,2,2,2,2,2,2,2,2,2,2
